3333333333333333333333333333333333333333333333333333333333333333333333333333333333333333333333333333333333333333333333333333333333333333333333
3000000000000000000000000000000000000000000000000000000000000000000000000000000000000000000000000000000000000000000000000000000000000000000003
3000000000000000000000000000000000000000000000000000000000000000000000000000000000000000000333333333333300000000000000000000000000000000000003
3000000000000000000000000000000000000000000000000000000000000000000000000000000000000000033333333333333333000000000000000000000000000000000003
300000000000000000000000000000000000000000000000000000000000000000000000000000000000000003333333333333333300000000000000000000000000000000003
3000000000000000000000000000000000000000000000000000000000000000000000000000000000000000222222222222222222200000000000000000000000000000000003
3000000000000000000000000000000000000000000000000000000000000000000000000000000000000000020000000000000002000000000000000000000000000000000003
3000000000000000000000000000000000000000000000000000000000000000000000000000000000000000020000000000000002000000000000000000000000000000000003
3000000000000000000000000000000000000000000000000000000000000000000000000000000000000000000000000000000002000000000000000000000000000000000003
3000000000000000000000000000000000000000000000000000000000000000000000000000000000001000000000000000000002000000000000000000000000000000000003
3000000000000000000000000000000000000000000000000000000000000000000000000000000000011111111111111111111111111111000000000000000000000000000003
3000000000000000000000000000000000000000000000000000000000000000000000000000000000022222222222222222222222222220000000000000000000000000000003
3000000000000000000000000000000000000000000000000000000000000000000000000000000000000332223333332233332222233300000000000000000000000000000003
3000000000000000000000000000000000000000000000000000000000000000000000000000000300000003333303333333003322333000000000000000000000000000000003
3000000000000000000000000000000000000000000000000000000000000000000000000000000000000000333000033330000003330000000000000000000000000000000003
3000000000000000000000000000000000000000000000000000000000000000000000000000000000000000033000000330000000330000000000000000000000000000000003
3000000000000000000000000000000000300000030000000030000000030000000000000000000000000000003000000300000000300000000000000000000000000000000003
3000000000000000000000000000000000000000000000000000000000000000000000033000000000000000000000000000000000000000000000000000000000000000000003
3000000000000000000000000000000000000000000000000000000000000000000000000000000000000000000000000000000000000000000000000000000000000000000003
3000000000000000000000000000000000000000000000000000000000000000000000000000000000000000000000000000000000000000000000000000000000000000000003
3000000000000000000000033300000000000000000000000000000000000000000000000000000033300000000000000000000000000000000000000000000000000000000003
3000000000000000000000000000000000000000000000000000000000000000000000000000000000000000000000000000000033333000000000003333000000000000000003
3000000000000000000000000000000000000000000000000000000000000000000000000000000000000000000000000000000000000000000000000000000000000000000003
3000000000000000000000000000000000000000000000000000000000000000000000000000000000000000000033300000000000000000000000000000000000000000000003
3000000000000000033330000000003330000000000000000000000000000000000000000000000000000000000000000000000000000000000000000000000000000000000003
3000000000000000000000000000000000000000000000000000000000000000000000000000000000000000000000000000000000000000000000000000000000003333000003
3000000000000000000000000000000000000000000000000000000000000000000000000000000000000000000000000000000000000000000000000000000000000000000003
30000000000000000000000000000000000000000000000000000000000000000000000000000ccc00000000000000000000000000000000000000000000000000000000000003
3000000000000000000000000000000000000000000000000000000000000000000000000000c000c0000000000000000000000000000000000000000000000000000000000003
300000000000000000000000000000000000000000000000000000000000000000000000000c00000c000000000000000000000000000000000000003333300000000000000003
310000000111111000000000000000000000000000000000000000000000000000000000000c00000c000000000000000000000000000000000000000000000000000000000003
3210000112222221111100000000011110000000000000000000000000000000000000000000000000000000000000000000000000000000000000000000000000000000000003
3221111222222222222211111111122221100000000000000000000000000000000001111111111111111111111111111111111111111111111111111111111111111111111113
3222222222222222222222222222222222211100000000111111110000000000011112222222222222222222222222222222222222222222222222222222222222222222222223
3222222222222222222222222222222222222210001111222222221111111111122222222222222222222222222222222222222222222222222222222222222222222222222223
3222222222222222222222222222222222222221112222222222222222222222233333233222222333322222233333222222333333332222222233323232322222322222223333
3222333333333222222222233333333333333222333333333332233322333333333333333333333333333333333333333333333333333333333333333333333333333333333333
3333333333333333322233333333333333333333333333333333333333333333333333333333333333333333333333333333333333333333333333333333333333333333333333
3333333333333333333333333333333333333333333333333333333333333333333333333333333333333333333333333333333333333333333333333333333333333333333333
3333333333333333333333333333333333333333333333333333333333333333333333333333333333333333333333333333333333333333333333333333333333333333333333
3333333333333333333333333333333333333333333333333333333333333333333333333333333333333333333333333333333333333333333333333333333333333333333333
